0000000000000
00XXXXXXXX000
00X000000X000
00X000000X000
00XXXXXXXX000
0000000000000
00XXXXXXXX000
00X000000X000
00X000000X000
00XXXXXXXX000
0000000000000
0000000000000