0000000000000
00000XX000000
00000XX000000
0000XXXX00000
000XXXXXX0000
00XXXXXXXX000
00XXXXXXXX000
0000000000000
0000000000000
0000000000000
0000000000000
0000000000000