0000000000000
0000000000000
0000XXXX00000
000XXXXXX0000
000XX00XX0000
000XX00XX0000
000XX00XX0000
000XXXXXX0000
0000XXXX00000
0000000000000
0000000000000
0000000000000