0000000000000
000XXXXX00000
000X000X00000
000X000X00000
000XXX0X00000
00000X0X00000
000XXX0X00000
000X000X00000
000X000X00000
000X000X00000
0000000000000
0000000000000