0000000000000
00000XX000000
0000XXXX00000
0000XXXX00000
000XX00XX0000
00XXX00XXX000
000XX00XX0000
0000XXXX00000
0000XXXX00000
00000XX000000
0000000000000
0000000000000