0000000000000
00XXX00XXX000
00X0X00X0X000
00XXX00XXX000
0000XXXX00000
0000X00X00000
0000XXXX00000
00XXX00XXX000
00X0X00X0X000
00XXX00XXX000
0000000000000
0000000000000