0000000000000
00000XX000000
0000XXXX00000
000X0XX0X0000
000X0XX0X0000
00XXXXXXXX000
000X0XX0X0000
000X0XX0X0000
0000XXXX00000
00000XX000000
0000000000000
0000000000000