0000000000000
00XX0000XX000
00XX0000XX000
000XX00XX0000
0000XXXX00000
00000XX000000
0000XXXX00000
000XX00XX0000
00XX0000XX000
00XX0000XX000
0000000000000
0000000000000