0000000000000
00000XX000000
0000XXXX00000
000XXXXXX0000
00000XX000000
00000XX000000
00000XX000000
000XXXXXX0000
0000XXXX00000
00000XX000000
0000000000000
0000000000000