0000000000000
0000SSSS00000
0000XXXX00000
0000SSSS00000
00XXXXXXXX000
00XXSSSSXX000
00XXXXXXXX000
0000SSSS00000
0000XXXX00000
0000SSSS00000
0000000000000
0000000000000